year	nucleosome_w/_bp	nucleosome_w/bp_cum	nucleosome_only	nucleosome_only_cum	all_nucleosomes
Until ‘99	0	0	1	1	1
‘99	0	0	0	1	0
‘00	0	0	3	4	3
‘01	0	0	2	6	2
‘02	0	0	3	9	3
’03	0	0	3	12	3
‘04	0	0	13	25	13
‘05	0	0	4	29	4
‘06	1	1	2	31	3
‘07	0	1	5	36	5
‘08	0	1	2	38	2
’09	0	1	1	39	1
‘10	1	2	13	52	14
‘11	1	3	16	68	17
‘12	0	3	8	76	8
‘13	3	6	10	86	13
‘14	1	7	4	90	5
‘15	1	8	20	110	21
‘16	3	11	17	127	20
‘17	6	17	23	150	29
‘18	3	20	5	155	8
