YEAR	nucleosome_w/bp	nucleosome_w/bp_cumulative	NUCLEOSOME_ONLY	NUCLEOSOME_ONLY_CUMULATIVE	All_nucleosomes
Until ‘99	0	0	1	1	1
’99-‘00	0	0	3	4	3
’01-‘02	0	0	5	9	5
’03-‘04	0	0	16	25	16
’05-‘06	1	1	6	31	7
’07-‘08	0	1	7	38	7
’09-‘10	1	2	14	52	15
’11-‘12	1	3	24	76	25
’13-‘14	4	7	14	90	18
’15-‘16	4	11	37	127	41
’17-‘18	9	20	28	155	37
